........................
........................
...XXXX.................
...XXX..................
....XXXX..........O.....
......XXXX........O..O..
..................OOOO..
...................OOO..
........................
........................
