.........................
.........................
...XXXXXXXXXX............
...XXX...................
....XXXX..........O......
......X...........O..O...
..................OOOO...
...................OOO...
.........................
.........................
